111111111111111111111111111
101000000000000000000000001
101000000000000000000000001
101000000000000000000000001
101000000000000000000000001
100000000000000000000000001
100000000000000000000000001
100000000000000000000000001
100000000000000000000000001
100000000000000000000000001
100000000000000000000000001
100000000000000000000000001
100000000000000000000000001
100000000000000000000000001
100000000000000000000000001
100000000000000000000000001
111111111111111111111111111